#########################################
|                                       #
# ############################### ##### #
#     #   #         #           # #     #
# ##### ### # # ##### # ### # ##### ### #
#         # # #     # #   # # #       # #
# # # ### ### # ### ### # ##### # # # # #
# # #   #   # #   # # # #       # # # # #
# ### # # ##### ##### # ### # # ### ### #
#   # # #             # #   # # #       #
# # ##### # # # # # # ### # ##### # ### #
# #     # # # # # # # #   #     # #     #
# # # # # ##### # # ### # # # ##### # # #
# # # # # #     # #     # # # #   # # # #
# ### ##### # # ### ### # ####### ##### #
#   #     # # # #     # # #           # #
# ### # # ##### # # # # # # # # # # ### #
#   # # #     # # # # # # # # # # #     #
# # # # # # ##### # ### ### # # ### # # #
# # # # # #     # #   # #   # # #   # # #
######################################### 